Code	NameID	Modification
3Me-Glu	Glu	methylation
3OH-Leu	Leu	hydroxylation
3OH-Pro	Pro	hydroxylation
4Cl-Thr	Tcl	-
4Me-Pro	Pro	methylation
4OH-Pro	Pro	hydroxylation
Abu	Abu	-
Ala	Ala	-
Arg	Arg	-
Asn	Asn	-
Asp	Asp	-
Cys	Cys	-
Dab	Dab	-
Dhpg	Dhpg	-
End	End	-
Fo-OH-Orn	Orn	formylation+hydroxylation
Gln	Gln	-
Glu	Glu	-
Gly	Gly	-
His	His	-
Hpg	Hpg	-
Hpr	Pip	-
Ile/aIle	Ile	-
Kyn	Kyn	-
Leu	Leu	-
Lys	Lys	-
NFo-Ile	Ile	formylation
NFo-OH-Orn	Orn	formylation+hydroxylation
NFo-Val	Val	formylation
NMe-Bmt	Bmt	methylation
NMe-Gly	Gly	methylation
NMe-Hpg	Hpg	methylation
NMe-Leu	Leu	methylation
NMe-Phe	Phe	methylation
NMe-Ser	Ser	methylation
NMe-Thr	Thr	methylation
NMe-Val	Val	methylation
NMe-aIle/NMe-Ile	Ile	methylation
OH-Asn	Asn	hydroxylation
OH-Asp	Asp	hydroxylation
OH-Orn	Orn	hydroxylation
OH-cOrn	Orn	hydroxylation
Orn	Orn	-
Phe	Phe	-
Pro	Pro	-
Ser	Ser	-
Trp	Trp	-
Tyr	Tyr	-
Val	Val	-
aThr/Thr	Thr	-
bAla	Bal	-
bMe-Asp	Asp	methylation
bMe-Phe	Phe	methylation
bOH-NMe-Val	Val	hydroxylation+methylation
bPhe	Phe	-
dh-Trp	Trp	dehydration
dhAbu	Abu	dehydration
dhCys	Cys	dehydration
