Code	NameID	Modification
Ala	ala	-
Gly	gly	-
Leu	leu	-
Val	val	-
aThr/Thr	thr	-
Ser	ser	-
Ile/aIle	ile	-
Cys	cys	-
Asn	asn	-
Pro	pro	-
Asp	asp	-
Gln	gln	-
Phe	phe	-
Lys	lys	-
Trp	trp	-
Glu	glu	-
Arg	arg	-
Abu	abu	-
Tyr	tyr	-
Hpg	hpg	-
NMe-Val	val	MT
His	his	-
diOH-Bz	dhb	-
NMe-Thr	thr	MT
NMe-Leu	leu	MT
Dab	dab	-
NMe-Gly	gly	MT
Hiv	hiv	-
NMe-Phe	phe	MT
bMe-Asp	asp	MT
bMe-Phe	phe	MT
Dhpg	dhpg	-
Orn	orn	-
NMe-Cys	cys	MT
N2Me-Asn	asn	MT
Met	met	-
bAla	b-ala	-
bLys	b-lys	-
NMe-Hpr	pip	MT
4Me-Pro	pro	MT
Dpr	dpr	-
Hpr	pip	-
bOH-Tyr	bht	-
NMe-Ser	ser	MT
4Me-Hva	HICA	-
Hse	hse	-
NMe-aIle/NMe-Ile	ile	MT
Hty	hty	-
NMe-Ala	ala	MT
diMe-Cys	cys	MT
Cap	cap	-
3Me-Glu	glu	MT
NMe-Asn	asn	MT
3Me-Pro	pro	MT
NMe-OMe-Tyr	tyr	MT
OMe-Thr	thr	MT
Aad	aad	-
NMe-Hty	hty	MT
Pha	phe-ac	-
aMe-Cys	cys	MT
NMe-Tyr	tyr	MT
NMe-Hpg	hpg	MT
NMe-Bmt	bmt	MT
NdMe-Ala	ala	MT
bMe-Gln	gln	MT
bMe-Ile	ile	MT
Valol	vol	-
NMe-OMe-Thr	thr	MT
NMe-bMe-Leu/diMe-aIle	leu	MT
Kyn	kyn	-
NMe-Pro	pro	MT
CysA	cysa	-
OMe-Trp	trp	MT
NMe-Trp	trp	MT
ph-Gly/Ph-Gly	phg	-
NMe-Ph-Gly	phg	MT
NMe-bOMe-Tyr	tyr	MT
NMe-Glu	glu	MT
b3Me-Glu	glu	MT
NMe-bMe-Ile	ile	MT
3Me-Hty	hty	MT
NMe-Cap	cap	MT
3Me-4Me-Gln	gln	MT
3OMe-Ala	ala	MT
NMe-N2Me-Asn	asn	MT
NMe-bOMe-Asp	asp	MT
bbMe-NMe-Trp	trp	MT
NMe-3Me-4Me-Gln	gln	MT
b1Me-Trp	trp	MT
NMe-Met	met	MT
bMe-Asn	asn	MT
NMe-3Me-Pro	pro	MT
NMe-Asp	asp	MT
bbMe-Asn	asn	MT
NMe-CysA	cysa	MT
NMe-Dpr	dpr	MT
NMe-Gln	gln	MT
b3Me-Hty	hty	MT
OMe-Asp	asp	MT
bOMe-Tyr	tyr	MT
NMe-3Me-Hty	hty	MT
NtMe-Leu	leu	MT
MeO-Glu	glu	MT
NMe-3Me-Glu	glu	MT
b3Me-4Me-Gln	gln	MT
NMe-Arg	arg	MT
bbNMe-NMe-Trp	trp	MT
NMe-bMe-Asn	asn	MT
NMe-bMe-Asp	asp	MT
b3Me-Phe	phe	MT
NMe-5Me-Pro	pro	MT
NMe-OMe-Ile	ile	MT
bbOMe-Asp	asp	MT
NMe-Aad	aad	MT
NMe-Kyn	kyn	MT
NdMe-Leu	leu	MT
bbMe-Asp	asp	MT
NMe-Lys	lys	MT
NMe-Orn	orn	MT
NMe-Dhpg	dhpg	MT
1Me-Trp	trp	MT
3Me-Phe	phe	MT
NMe-Abu	abu	MT
bN2Me-Asn	asn	MT
bbMe-Phe	phe	MT
bbOMe-Tyr	tyr	MT
NMe-1Me-Trp	trp	MT
bbMe-Gln	gln	MT
bMeO-Glu	glu	MT
NMe-OMe-Trp	trp	MT
NMe-Hse	hse	MT
NMe-bAla	b-ala	MT
Bmt	bmt	-
Ival	iva	-
Me2-Bmt	bmt	MT
NMe-OMe-Asp	asp	MT
NMe-MeO-Glu	glu	MT
bOMe-Thr	thr	MT
NMe-3Me-Phe	phe	MT
NMe-bMe-Gln	gln	MT
bThr	thr	-
NMe-bMe-Phe	phe	MT
5Me-Pro	pro	MT
NMe-His	his	MT
NMe-4Me-Pro	pro	MT
NMe-Dab	dab	MT
bOMe-Asp	asp	MT
bOMe-Trp	trp	MT
Aeo	aeo	-
NMe-Aeo	aeo	MT
3PAL	33p-l-ala	-
NMe-3PAL	33p-l-ala	MT
4PPro	4ppro	-
NMe-4PPro	4ppro	MT
Alaol	alaninol	-
Dht	dht	-
NMe-Dht	dht	MT
GlyA	glycolic-acid	-
Hyv	hyv	-
NMe-Hyv	hyv	MT
ICA	indole-3-carboxylic	-
LDAP	LDAP	-
NMe-tCl-Leu	tcl	MT
tCl-Leu	tcl	-
Lyserg	lyserg	-
Oiv	2-oxo-isovaleric-acid	-
NMe-Piz	piperazic	MT
Piz	piperazic	-
Sal	sal	-